16 18
KILL_ALL_ENEMIES
*	*	*	*	*	*	*	*	*	*	*	*	*	*	*	*	*	*
*	.P	.>	.-	.	.	.+	.	.	.	.	.	.	.	.	.	.	*
*	.	.^	*	.	.	*	*	*	*	.	.	*	*	*	*	.	*
*	.	.	*	*	.	.	.	.	.	.	.	.	.	.	*	.	*
*	.	.	.	.	.	.	.	*	.	.	.3	.	.!	.	.	.	*
*	.	.	.	.	.	.	.I	*	.	.	.	.	.	.	.	.	*
*	.	.	.	.	.	*	.	*	*	.	.	.	*	.	.	.	*
*	.	.	.	.	.	*	.	.	.	.	.	*	*	.	.	.	*
*	#	#	*	*	*	*	.	*	*	*	.	.	*	.	.	.1	*
*	.	.	.	.	.	.	.	.   *   .	.	.	*	*	.	.	*
*	.	.	*	.	*	*	.$	.	.	.	.>	.	.	.	.	.	*
*	.	.	*	.	.	*	.	*	*	*	.	*	.	.	.	.	*
*	.	.	*	.	.	.	.	.	*	.	.	*	.	.	.	.	*
*	.	.4	*	*	*	.	.	.	.	.	.	*	*	*	.	.	*
*	.	.	.	.	.	.	.	.	.	.	.	.2	.	.	.	.-	*
*	*	*	*	*	*	*	*	*	*	*	*	*	*	*	*	*	*