5	5
A
P	*	*	*	*
+	.	/	O	.
.	$	.	1	.
*	H	.	*	*
*	*	K	|	X
2	4	3	4
