9 8
B
.	.	*	*	*   *   *   .
*   *   *   .   .   .   *   .
*   /   .P  .O  .   .   *   .
*   *   *   .   .O  /   *   .
*   /   *   *   .O  .   *   .
*   .   *   .   /   .   *   *
*   .O  .   /O  .O  .O  /   *
*   .   .   .   ./  .   .   *
*   *   *   *   *   *   *   *
