5   5
P   *   *   *   *
+   .   /   O   .
.   $   .   1   .
*   .   .   *   *
*   *   K   |   X
A
2,4,    3,4