A

P   *   *   *   *
+   .   /   O   .
.   $   .   1   .
*   .   .   *   *
*   *   K   |   X