5	5
A
P	*	*	*	*
+	.	/	O	.
-	$	.	1	.
*	.	.	*	*
*	*	K	|	X
4	2	4	3
