5	5
P	*	*	*	*	
+	.	/	O	.	
.	$	.	1	.	
*	.	.	*	*	
*	*	K	|	X	
A	
4	2	4	3
